# German translation by ADI
cancelled line=Linie abgebrochen
Cancelled transaction=Transaktion abgebrochen
Chest-shop activation/deactivation cancelled=Shop Chest aktivation/deaktivation abgebrochen
Click on the chest-shop to activate/deactivate=Klicke auf den Chest Shop um ihn zu aktivieren/deaktivieren
Click on the chest-shop to add buy items=Klicke auf den Chest um Verkaufs Sachen hinzuzufügen
Click on the chest-shop to add sell items=Klicke auf den Chest Shop um Verkaufs Sachen hinzuzufügen
Click on the chest-shop to exclude buy items=Klicke auf den Chest Shop um Kauf Sachen zu entnehmen
Click on the chest-shop to exclude sell items=Klicke auf den Chest Shop um Verkaufs Sachen zu entnehmen 
earned=verdient
expense=kosten
into your pocket=in deine Tasche
Nothing can be sold here=Hier kann nichts verkauft werden
Nothing to buy here=Hier kann nichts gekauft werden
Now players can buy=Jetzt können die Spieler kaufen
Now players can not buy=Jetz können die Spieler nichts kaufen
Now players can not sell=Jetzt können die Spieler nichts verkaufen
Now players can sell=Jetzt können die Spieler verkaufen
Only ops can activate/deactivate chest-shops=Nur OPs können die Shop Chests aktivieren/deaktivieren
price=Preis
profit=Profit
purchase=kaufen
sale=Verkauf
spent=ausgegeben
This chest belongs to=Dieser Chest gehört
This chest is not a shop anymore=Dieser Chest ist kein Shop mehr
This chest is now a shop=Dieser Chest ist jetzt ein Shop
This chest belongs to=Dieser Chest gehört
This shop is already in use by another player=TR:This shop is already in use by another player
This shop was given to=TR:This shop was given to
Transaction total=Total transaction
Usage=Verwendung
Welcome into this shop=Willkommen in diesem Shop
Welcome into your shop=Willkommen in dein Shop
You are not allowed to break a shop-chest=Du hast nicht die Berechtigung einen Chest-Shop zu zerstören
You can buy=Du kannst kaufen
You can sell=Du kannst verkaufen
you have=du hast
You've got=Du hast bekommen
