# Spanish translation by Anihilatore
cancelled line=Linea Cancelada
Cancelled transaction=Transaccion Cancelada
Shop-chest activation/desactivation cancelled=Cofre-Tienda Activacion/Desactivacion Cancelada
Click on the shop-chest to activate/desactivate=Click en el Cofre-tienda para Activar/Desactivar
Click on the shop-chest to add buy items=Click en el Cofre-tienda para agregar objetos para vender
Click on the shop-chest to add sell items=Click en el Cofre-tienda para agregar objetos para comprar
Click on the shop-chest to exclude buy items=Click en el Cofre-tienda para excluir objetos para vender
Click on the shop-chest to exclude sell items=Click en el Cofre-tienda para excluir objetos para Comprar
earned=Obtenido
expense=Perdido
into your pocket=En tu cartera
Nothing can be sold here=Nada puede ser vendido aqui
Nothing to buy here=Nada que comprar aqui
Now players can buy= Ahora los jugadores pueden comprar
Now players can not buy=Ahora los jugadores no pueden comprar
Now players can not sell=Ahora los jugadores no pueden vender
Now players can sell=Ahora los jugadores pueden vender
Only ops can activate/desactivate shop-chests=Solo OPs pueden Activar/Desactivar cofres-tienda
price=Precio
profit=Ganancia
purchase=Compra
sale=Venta
spent=Gastado
This chest belongs to=Este cofre pertenece a
This chest is not a shop anymore=Este cofre ya no es una tienda
This chest is now a shop=Este cofre es ahora una tienda
This chest belongs to=Este cofre pertenece a
This shop is already in use by another player=Esta tienda ya esta en uso por otro jugador
Total transaction=Transaction total
Welcome into this shop=Bienvenido a esta tienda
Welcome into your shop=Bienvenido a esta tienda
You are not allowed to break a shop-chest=No tienes autorizacion para destruir un cofre tienda
You can buy=Puedes comprar
You can sell=Puedes vender
you have=Tu tienes
You've got=Tu obtuviste