# French translation by TICKLEMAN
cancelled line=ligne annulee
Cancelled transaction=Transaction annulee
Chest-shop activation/desactivation cancelled=Activation/desactivation du coffre annulee
Click on the chest-shop to activate/desactivate=Cliques sur le coffre-magasin a activer/desactiver
Click on the chest-shop to add buy items=Cliques sur le coffre-magasin pour autoriser des articles a la vente
Click on the chest-shop to add sell items=Cliques sur le coffre-magasin pour autoriser des articles a l'achat
Click on the chest-shop to exclude buy items=Cliques sur le coffre-magasin pour exclude des articles a la vente
Click on the chest-shop to exclude sell items=Cliques sur le coffre-magasin pour exclude des articles a l'achat
earned=gagne
expense=depense
into your pocket=en poche
Nothing can be sold here=Rien ne peut etre vendu ici
Nothing to buy here=Il n'y a rien a acheter ici
Now players can buy=Les joueurs peuvent acheter
Now players can not buy=Les joueurs ne peuvent pas acheter
Now players can not sell=Les joueurs ne peuvent pas vendre
Now players can sell=Les joueurs peuvent vendre
Only ops can activate/desactivate chest-shops=Seuls les Op peuvent activer/desactiver un coffre-magasin
price=prix
profit=gain
purchase=achat
sale=vente
spent=depense
This chest belongs to=Ce magasin appartient a
This chest is not a shop anymore=Ce coffre n'est plus en mode magasin
This chest is now a shop=Ce coffre est maintenant en mode magasin
This chest belongs to=Ce coffre-magasin appartient a
This shop is already in use by another player=Ce magasin est deja utilise par un autre joueur
This shop was given to=Ce magasin est donne a
Transaction total=Total transaction
Usage=Utilisation
Welcome into this shop=Bienvenue au magasin
Welcome into your shop=Bienvenue dans ton magasin
You are not allowed to break a shop-chest=Tu n'es pas autorise a detruire un coffre-magasin
You can buy=Tu peux acheter
You can sell=Tu peux vendre
you have=tu as
You've got=Tu as
